8,13,65
XXXXXXXXXXXXX
XXXXXXX_@_XXX
X_______*__XX
X._._._._.__X
X*_*_*_*___XX
X_X_XXXXXXXXX
X___XXXXXXXXX
XXXXXXXXXXXXX