8,15,90
XXXXXXXXXXXXXXX
XX____XXXXXXXXX
X_*XX__XXXXX__X
X_____@.._XX*_X
X_*X___.._____X
X___*XXXX__XXXX
XX___XXXXXXXXXX
XXXXXXXXXXXXXXX