10,14,120
XXXXXXXXXXXXXX
X..__X_____XXX
X..__X___@___X
X____X*XXXX__X
X________XX__X
X____X*_*___XX
XXXXXX@XX____X
XXX__________X
XX_____X_____X
XXXXXXXXXXXXXX